+++++++++++++++++++++++++
+  + +   +   +   +   ++ +
++ + + + + + + +   +    +
++ + +++ + + + ++++++++ +
+  +     + + +   +    + +
+ +++ ++++ + + + + ++   +
+          + + + + ++++++
++++++++++++ +++ +  +   +
+  +   +   +   + ++ + +++
++ + +   + + +++  + +   +
++ + +++++ + + + ++ + + +
++ +     +   +    + +++ +
++ +++++ ++ +++++ +     +
+      + ++     + +++ + +
+ ++++++ +  +++ +   + + +
+        + ++ + +++ + + +
++++++++++ +  +   + + + +
+    +   +++ ++++ + + + +
+ ++ + +        + + +++ +
+  + + +++++ ++ + + + + +
+ ++ + + +   +  +   +   +
+ +  + +   +++ +++++++ ++
+ ++++ + +   + +     + ++
+      + +++ +   +++   ++
+++++++++++++++++++++++++